{
    "settings":"default",
    "maxTime":115,
    "grid": [
    ["d", "", "", "", "", "", "", "", "", "", "", "", "", "", "", "", "", "", "", "", "", "", "", "", "", "", "", "", "", "", "", "", "", "", "", "", "", "", "", "", "", "", "", "", "", "", "", "", "", "", "", "", "", "", "", "", "", "", "", "", "", "", "", "", "", "", "", "", "", "", "", "", "", "", "", "", "", "", "", "", "", "", "", "", "", "", "", "", "", "", "", "", "", "", "", "", "", "", "", "", "", "", "", "", "", "", "", "", "", "", "", "", "", "", "", "", "", "", "", "", "", "", "", "", "", "", "", "", "","d"],
    ["d", "", "", "", "", "", "", "", "", "", "", "", "", "", "", "", "", "", "", "", "", "", "", "", "", "", "", "", "", "", "", "", "", "", "", "", "", "", "", "", "", "", "", "", "", "", "", "", "", "", "", "", "", "", "", "", "", "", "", "", "", "", "", "", "", "", "", "", "", "", "", "", "", "", "", "", "", "", "", "", "", "", "", "", "", "", "", "", "", "", "", "", "", "", "", "", "", "", "", "", "", "", "", "", "", "", "", "", "", "", "", "", "", "", "", "", "", "", "", "", "", "", "", "", "", "", "", "", "","d"],
    ["d", "", "", "", "", "", "", "", "", "", "", "", "", "", "", "", "", "", "", "", "", "", "", "", "", "", "", "", "", "", "", "", "", "", "", "", "", "", "", "", "", "", "", "", "", "", "", "", "", "", "", "", "", "", "", "", "", "", "", "", "", "", "", "", "", "", "", "", "", "", "", "", "", "", "", "", "", "", "", "", "", "", "", "", "", "", "", "", "", "", "", "", "", "", "", "", "", "", "", "", "", "", "", "", "", "", "", "", "", "", "", "", "", "", "", "", "", "", "", "", "", "", "", "", "", "", "", "", "","d"],
    ["d", "", "", "", "", "", "", "", "", "", "", "", "", "", "", "", "", "", "", "", "", "", "", "", "", "", "", "", "", "", "", "", "", "", "", "", "", "", "", "", "", "", "", "", "", "", "", "", "", "", "", "", "", "", "", "", "", "", "", "", "", "", "", "", "", "", "", "", "", "", "", "", "", "", "", "", "", "", "", "", "", "", "", "", "", "", "", "", "", "", "", "", "", "", "", "", "", "", "", "", "", "", "", "", "", "", "", "", "", "", "", "", "", "", "", "", "", "", "", "", "", "", "", "", "", "", "", "", "","d"],
    ["d", "", "", "", "", "", "", "", "", "", "", "", "", "", "", "", "", "", "", "", "", "", "", "", "", "", "", "", "", "", "", "", "", "", "", "", "", "", "", "", "", "", "", "", "", "", "", "", "", "", "", "", "", "", "", "", "", "", "", "", "", "", "", "", "", "", "", "", "", "", "", "", "", "", "", "", "", "", "", "", "", "", "", "", "", "", "", "", "", "", "", "", "", "", "", "", "", "", "", "", "", "", "", "", "", "", "", "", "", "", "", "", "", "", "", "", "", "", "", "", "", "", "", "", "", "", "", "", "","d"],
    ["d", "", "", "", "", "", "", "", "", "", "", "", "", "", "", "", "", "", "", "", "", "", "", "", "","s","s","s", "", "", "", "", "", "", "", "", "", "", "", "", "", "", "", "", "", "", "", "", "", "", "", "", "","g","g","g","g", "", "", "", "", "", "", "", "", "", "", "", "","g","g","g","g", "", "", "", "", "", "", "", "", "", "", "", "", "", "", "","g","g","g","g", "", "", "", "", "", "", "", "", "", "", "", "", "", "", "", "", "", "", "", "", "", "", "", "", "", "", "", "", "", "", "", "", "", "", "", "", "","d"],
    ["d", "", "", "", "", "", "", "", "", "", "", "", "", "", "", "", "","g","g","g","g", "", "", "", "", "", "", "", "", "", "", "", "", "", "","g","g","g","g","g","g","g","g", "", "", "", "", "", "", "", "", "", "","d","d","d","d", "", "", "", "", "", "", "", "", "", "", "", "","d","d","d","d", "", "", "", "", "", "", "", "", "", "", "", "", "", "", "","d","d","d","d", "", "", "", "", "", "", "", "", "", "", "", "", "", "", "", "", "", "", "", "", "", "", "", "", "", "", "", "", "", "", "", "", "", "", "", "", "","d"],
    ["d", "", "", "", "", "", "", "","s","s","s", "", "", "", "", "", "","d","d","d","d", "", "", "", "", "", "", "", "", "", "", "", "", "","g","d","d","d","d","d","d","d","d","g","g", "", "", "", "", "", "", "", "", "","d","d", "", "", "", "", "", "", "", "", "", "", "", "", "", "","d","d", "", "", "", "", "", "", "", "", "", "", "", "", "", "", "", "", "","d","d", "", "", "", "", "", "", "", "", "", "", "", "", "", "", "", "", "", "", "", "", "", "", "", "", "", "", "", "", "", "", "", "", "", "", "", "", "", "","d"],
    ["d", "", "", "", "", "", "", "", "", "", "", "", "", "", "", "", "", "","d","d", "", "", "", "", "", "", "", "", "", "", "", "", "", "","d","d","d","d","d","d","d","d","d","d","d","g", "", "", "", "", "", "", "", "", "", "", "", "", "", "", "", "", "", "", "", "", "", "", "", "", "", "", "", "", "", "", "", "", "", "", "", "", "", "", "", "", "", "", "", "", "", "", "", "", "", "", "", "", "", "", "", "", "", "", "", "", "","s","s","s", "", "", "", "", "", "", "", "", "", "", "", "", "", "", "", "", "", "", "","d"],
    ["d", "", "", "", "", "", "", "", "", "", "", "", "", "","s","s", "", "", "", "", "", "", "", "", "", "", "", "", "","s","s", "", "", "", "","d","d","d", "","d","d","d","d","d","d","d", "", "", "", "", "", "", "", "", "", "", "", "", "", "", "", "", "", "", "", "", "", "", "", "", "", "", "", "", "", "", "", "", "", "", "", "", "", "", "", "", "", "", "", "", "", "", "", "", "", "", "", "", "", "", "", "", "", "", "", "", "", "", "", "", "", "", "", "", "", "", "", "","g", "", "", "", "", "", "", "", "", "", "","d"],
    ["d", "", "", "", "", "", "", "", "", "", "", "", "", "", "", "", "", "", "", "", "", "", "", "", "", "", "", "", "", "", "", "", "", "", "", "","d", "", "", "","d","d","d","d","d","d","g", "", "", "", "", "", "", "", "", "", "", "", "", "", "", "", "", "", "", "", "", "", "", "", "", "", "", "", "", "", "", "", "", "", "", "", "", "", "", "", "", "", "", "", "", "", "", "", "", "", "", "", "","s","s","s", "", "", "", "", "", "", "", "", "", "", "", "", "", "", "", "","d","g", "", "", "", "", "", "", "", "", "","d"],
    ["d", "", "", "", "", "", "", "", "","s","s","s", "", "", "", "", "", "", "", "", "", "", "","s","s", "", "", "", "", "", "", "", "", "", "", "", "", "", "", "", "","d","d","d","d","d","d","g", "", "", "", "", "", "", "", "", "", "", "", "", "", "", "", "", "", "", "", "", "", "", "", "", "", "", "", "", "", "", "", "", "", "", "", "", "", "", "", "", "", "", "", "", "", "", "", "", "", "", "", "", "", "", "", "", "", "", "", "", "", "", "", "", "", "", "", "", "", "","d","d", "", "", "", "", "", "", "", "", "","d"],
    ["d", "", "", "", "", "", "", "", "", "", "", "", "", "", "", "", "", "", "", "", "", "", "", "", "", "", "", "", "", "", "", "", "", "", "", "", "", "", "", "", "", "","d","d","d","d","d","d", "", "", "", "", "", "", "", "", "", "", "", "", "", "", "", "", "", "", "", "", "", "", "", "", "", "", "", "", "", "", "", "", "", "", "", "", "", "", "", "", "", "", "", "", "", "", "", "", "", "", "", "", "", "", "", "", "", "", "","s","s","s", "", "", "", "", "", "", "", "","d","d", "", "", "", "", "", "", "", "", "","d"],
    ["d","g","g","g", "", "", "", "", "", "", "", "", "", "", "", "", "", "", "", "", "", "", "", "", "", "", "", "", "", "", "","s","s","s", "", "", "", "", "", "", "", "","d","d","d","d","d","d","g", "", "", "","s","s","s", "", "", "", "", "", "", "", "", "", "", "", "", "", "", "", "", "", "", "", "", "", "", "", "", "", "", "", "", "", "", "", "", "", "", "", "", "", "", "", "", "", "", "", "", "", "", "", "", "", "", "", "", "", "", "", "", "", "", "", "", "", "", "","d","d", "", "", "", "", "", "", "", "", "","d"],
    ["d","d","d","d", "", "", "", "", "", "", "", "", "", "", "", "", "", "", "", "", "", "", "","s","s","s", "", "", "", "", "", "", "", "", "", "", "", "", "", "", "","g","d","d","d","d","d","d","d", "", "", "", "", "", "", "", "", "", "", "", "", "", "", "", "", "", "", "", "", "", "", "", "", "", "", "", "", "", "", "", "", "", "", "", "", "", "", "", "", "", "", "", "", "", "", "", "","s","s","s", "", "", "", "", "", "", "", "", "", "", "", "", "", "", "", "", "","g","d","d", "", "", "", "", "", "", "", "","g","d"],
    ["d","d","d", "", "", "", "","s","s","s", "", "", "", "", "", "", "", "", "", "", "", "", "", "", "", "", "", "", "", "", "", "", "", "", "", "", "", "", "", "","g","d","d","d","d","d","d","d","d", "", "", "", "", "", "", "", "", "", "","s","s","s", "", "", "", "", "", "", "", "", "", "", "", "", "", "", "","g","g", "", "", "", "", "", "","s","s","s", "", "", "", "", "", "", "", "", "", "", "", "", "", "", "", "", "", "", "", "", "", "", "", "", "", "", "", "", "","d","d","d","g", "", "", "", "", "", "", "","d","d"],
    ["d","d","d", "", "", "", "", "", "", "", "", "", "", "","s","s","s", "", "", "", "", "", "", "", "", "", "", "", "", "", "", "", "", "", "", "", "", "", "", "","d","d","d","d","d","d","d","d", "", "", "", "", "", "", "", "", "", "", "", "", "", "", "", "", "", "", "", "", "","s","s","s", "", "", "", "", "","d","d", "", "", "", "", "", "", "", "", "", "", "", "", "", "", "", "", "", "", "", "", "", "", "", "", "", "", "","s","s","s","s","s","s","s","s", "", "", "","d","d","d","d", "", "", "", "", "", "", "","d","d"],
    ["d","d","d", "", "", "", "", "", "", "", "", "", "", "", "", "", "", "", "", "", "", "", "", "", "", "", "", "", "", "", "", "", "", "", "", "", "", "", "", "","d","d","d","d","d","d","d","d", "", "", "", "", "", "", "", "", "", "", "", "", "", "", "", "", "", "", "", "", "", "", "", "", "", "", "", "", "","d","d","g", "", "", "", "", "", "", "", "", "", "", "", "", "", "", "", "", "", "", "", "", "", "", "", "", "", "", "", "", "", "", "", "", "", "", "", "", "","d","d","d","d", "", "", "", "", "", "", "","d","d"],
    ["d","d", "", "", "", "", "", "", "", "", "", "", "", "", "", "", "", "", "", "", "","s","s","s", "", "", "", "", "", "", "", "", "", "", "", "", "", "", "", "","d","d","d","d","d","d","d","d", "", "", "", "", "", "", "", "", "", "", "", "", "", "", "", "", "", "", "", "", "", "", "", "", "", "", "", "","g","d","d","d", "", "", "", "", "", "", "", "", "", "", "", "", "", "", "", "", "","s","s","s", "", "", "", "", "", "", "", "", "", "", "", "", "", "", "", "","g","d","d","d","d", "", "", "", "", "", "","g","d","d"],  
    ["d","d", "", "", "", "", "", "", "", "", "", "", "", "", "", "", "", "", "", "", "", "", "", "", "", "", "", "", "", "","s","s","s", "", "", "", "", "", "","g","d","d","d","d","d","d","d", "", "", "", "", "", "", "", "", "", "", "", "", "", "", "", "", "", "", "", "", "", "", "", "", "", "", "", "", "","d","d","d","d","g", "", "", "", "", "", "", "", "", "", "", "", "", "", "", "", "", "", "", "", "", "", "", "", "", "", "", "", "", "", "", "", "", "", "", "","d","d","d","d","d", "", "", "", "", "", "","d","d","d"], 
    ["d", "", "", "", "", "", "", "", "", "", "", "", "", "", "", "", "", "", "", "", "", "", "", "", "", "", "", "", "", "", "", "", "", "", "", "", "", "","g","d","d","d","d","d","d","d", "", "", "", "", "", "", "", "", "", "", "", "", "", "", "", "", "", "", "", "", "", "", "","s","s","s", "", "", "", "","d","d","d","d","d","g", "", "", "", "", "", "", "","s","s","s", "", "", "", "", "", "", "", "", "", "", "", "", "", "", "", "", "", "", "", "", "", "", "", "","d","d","d","d","d","g", "", "", "", "", "","d","d","d"],   
    ["d", "", "", "", "", "", "", "", "", "", "", "", "", "", "", "", "", "", "", "", "", "", "", "", "", "", "", "", "", "", "", "", "", "", "", "", "", "","d","d","d","d","d","d","d","d", "", "", "", "", "", "", "", "", "", "", "", "", "", "", "","s","s","s", "", "", "", "", "", "", "", "", "", "", "", "","d","d","d","d","d","d", "", "", "", "", "", "", "", "", "", "", "", "", "", "", "", "", "", "", "", "", "", "", "", "", "", "", "", "", "", "", "", "", "", "","d","d","d","d","d","d", "", "", "", "", "","d","d","d"],
    ["d", "", "", "", "", "", "", "", "", "", "", "", "", "", "", "", "", "", "", "", "", "", "", "", "", "", "", "", "", "","s","s","s", "", "", "", "", "","d","d","d","d","d","d","d","d", "", "", "", "", "", "", "", "", "", "", "", "", "", "", "", "", "", "", "", "", "", "", "", "", "", "", "", "", "","g","d","d","d","d","d","d","g", "", "", "", "", "", "", "", "", "", "", "", "", "", "", "","s","s","s", "", "", "", "", "", "", "", "", "", "", "", "", "", "", "","d","d","d","d","d","d", "", "", "", "", "","d","d","d"],
    ["d", "", "", "", "", "", "", "", "", "", "", "", "", "", "", "", "", "", "", "", "","s","s","s", "", "", "", "", "", "", "", "", "", "", "", "", "", "","d","d","d","d","d","d","d","d","g", "", "", "", "", "","s","s","s", "", "", "", "", "", "", "", "", "", "", "", "", "", "", "", "", "", "", "", "","d","d","d","d","d","d","d","d", "", "", "", "", "", "","s","s","s", "", "", "", "", "", "", "", "", "", "", "", "", "", "", "", "", "", "", "", "", "", "", "","g","d","d","d","d","d","d", "", "", "", "","g","d","d","d"],
    ["d", "", "", "", "", "", "", "","g","g","g","g","g", "", "", "", "", "", "", "", "", "", "", "", "", "", "", "", "", "", "", "", "", "", "", "", "","g","d","d","d","d","d","d","d","d","d", "", "", "", "", "", "", "", "", "", "", "", "", "", "", "", "", "", "", "", "", "", "", "", "", "", "", "", "","d","d","d","d","d","d","d","d","g", "", "", "", "", "", "", "", "", "", "", "", "", "", "", "", "", "", "", "", "", "", "", "", "", "", "", "", "", "", "", "","d","d","d","d","d","d","d", "", "", "", "","d","d","d","d"], 
    ["d","p", "", "", "", "","g","g","d","d","d","d","d","g", "", "", "", "", "", "", "", "", "", "", "", "", "", "", "", "", "", "", "", "", "", "", "","d","d","d","d","d","d","d","d","d","d","g", "", "", "", "", "", "", "", "", "", "", "", "", "", "", "", "", "", "", "", "", "", "", "", "", "", "", "","d","d","d","d","d","d","d","d","d", "", "", "", "", "", "", "", "", "", "", "", "", "", "", "", "", "", "", "", "", "", "", "", "", "", "", "", "", "", "", "","d","d","d","d","d","d","d","g", "", "", "","d","d","d","d"],  
    ["d","g","g","g","g","g","d","d","d","d","d","d","d","d","g","g","g","g","g","g","g","g","g","g","g","g","g","g","g","g","g","g","g","g","g","g","g","d","d","d","d","d","d","d","d","d","d","d","g","g","g","g","g","g","g","g","g","g","g","g","g","g","g","g","g","g","g","g","g","g","g","g","g","g","g","d","d","d","d","d","d","d","d","d","g","g","g","g","g","g","g","g","g","g","g","g","g","g","g","g","g","g","g","g","g","g","g","g","g","g","g","g","g","g","g","d","d","d","d","d","d","d","d","e","e","e","d","d","d","d"],
    ["d","d","d","d","d","d","d","d","d","d","d","d","d","d","d","d","d","d","d","d","d","d","d","d","d","d","d","d","d","d","d","d","d","d","d","d","d","d","d","d","d","d","d","d","d","d","d","d","d","d","d","d","d","d","d","d","d","d","d","d","d","d","d","d","d","d","d","d","d","d","d","d","d","d","d","d","d","d","d","d","d","d","d","d","d","d","d","d","d","d","d","d","d","d","d","d","d","d","d","d","d","d","d","d","d","d","d","d","d","d","d","d","d","d","d","d","d","d","d","d","d","d","d","d","d","d","d","d","d","d"],  
    ["d","d","d","d","d","d","d","d","d","d","d","d","d","d","d","d","d","d","d","d","d","d","d","d","d","d","d","d","d","d","d","d","d","d","d","d","d","d","d","d","d","d","d","d","d","d","d","d","d","d","d","d","d","d","d","d","d","d","d","d","d","d","d","d","d","d","d","d","d","d","d","d","d","d","d","d","d","d","d","d","d","d","d","d","d","d","d","d","d","d","d","d","d","d","d","d","d","d","d","d","d","d","d","d","d","d","d","d","d","d","d","d","d","d","d","d","d","d","d","d","d","d","d","d","d","d","d","d","d","d"],
    ["d","d","d","d","d","d","d","d","d","d","d","d","d","d","d","d","d","d","d","d","d","d","d","d","d","d","d","d","d","d","d","d","d","d","d","d","d","d","d","d","d","d","d","d","d","d","d","d","d","d","d","d","d","d","d","d","d","d","d","d","d","d","d","d","d","d","d","d","d","d","d","d","d","d","d","d","d","d","d","d","d","d","d","d","d","d","d","d","d","d","d","d","d","d","d","d","d","d","d","d","d","d","d","d","d","d","d","d","d","d","d","d","d","d","d","d","d","d","d","d","d","d","d","d","d","d","d","d","d","d"],
    ["d","d","d","d","d","d","d","d","d","d","d","d","d","d","d","d","d","d","d","d","d","d","d","d","d","d","d","d","d","d","d","d","d","d","d","d","d","d","d","d","d","d","d","d","d","d","d","d","d","d","d","d","d","d","d","d","d","d","d","d","d","d","d","d","d","d","d","d","d","d","d","d","d","d","d","d","d","d","d","d","d","d","d","d","d","d","d","d","d","d","d","d","d","d","d","d","d","d","d","d","d","d","d","d","d","d","d","d","d","d","d","d","d","d","d","d","d","d","d","d","d","d","d","d","d","d","d","d","d","d"]
  
  ]
}