{
    "setings":"default",
    "grid": [
    ["b", "", "", "", "", "", "", "", "", "", "", "", "", "", "", "", "", "", "", "", "", "", "", "", "", "", "", "", "", "", "", "", "", "", "", "", "", "", "", "", "", "", "", "", "", "", "", "", "", "", "", "", "", "", "", "", "", "", "", "", "", "", "", "", "", "","b", "", "", "", "", "", "", "", "", "", "", "", "", "", "", "", "", "", "", "", "", "", "", "", "", "", "", "", "", "", "", "", "", "", "", "", "", "", "", "", "", "", "", "", "", "", "", "", "", "", "", "", "", "", "", "", "", "", "", "", "", "", "","b"],
    ["b", "", "", "", "", "", "", "", "", "", "", "", "", "", "", "", "", "", "", "", "", "", "", "", "", "", "", "", "", "", "", "", "", "", "", "", "", "", "", "", "", "", "", "", "", "", "", "", "", "", "", "", "", "", "", "", "", "", "", "", "", "", "", "", "", "","b", "", "", "", "", "", "", "", "", "", "", "", "", "", "", "", "", "", "", "", "", "", "", "", "", "", "", "", "", "", "", "", "", "", "", "", "", "", "", "", "", "", "", "", "", "", "", "", "", "", "", "", "", "", "", "", "", "", "", "", "", "", "","b"],
    ["b", "", "", "", "", "", "", "", "", "", "", "", "", "", "", "", "", "", "", "", "", "", "", "", "", "", "", "", "", "", "", "", "", "", "", "", "", "", "", "", "", "", "", "", "", "", "", "", "", "", "", "", "", "", "", "", "", "", "", "", "", "", "", "", "", "","b", "", "", "", "", "", "", "", "", "", "", "", "", "", "", "", "", "", "", "", "", "", "", "", "", "", "", "", "", "", "", "", "", "", "", "", "", "", "", "", "", "", "", "", "", "", "", "", "", "", "", "", "", "", "", "", "", "", "", "", "", "", "","b"],
    ["b", "", "", "", "", "", "", "", "", "", "", "", "", "", "", "", "", "", "", "", "", "", "", "", "", "", "", "", "", "", "", "", "", "", "", "", "", "", "", "", "", "", "", "", "", "", "", "", "", "", "", "", "", "", "", "", "", "", "", "", "", "", "", "", "", "","b", "", "", "", "", "", "", "", "", "", "", "", "", "", "", "", "", "", "", "", "", "", "", "", "", "", "", "", "", "", "", "", "", "", "", "", "", "", "", "", "", "", "", "", "", "", "", "", "", "", "", "", "", "", "", "", "", "", "", "", "", "", "","b"],
    ["b", "", "", "", "", "", "", "", "", "", "", "", "", "", "", "", "", "", "", "", "", "", "", "", "", "", "", "", "", "", "", "", "", "", "", "", "", "", "", "", "", "", "", "", "", "", "", "", "", "", "", "", "", "", "", "", "", "", "", "", "", "", "", "", "", "","b", "", "", "", "", "", "", "", "", "", "", "", "", "", "", "", "", "", "", "", "", "", "", "", "", "", "", "", "", "", "", "", "", "", "", "", "", "", "", "", "", "", "", "", "", "", "", "", "", "", "", "", "", "", "", "", "", "", "", "", "", "", "","b"],
    ["b", "", "", "", "", "", "", "", "", "", "", "", "", "", "", "", "", "", "", "", "", "", "", "", "", "", "", "", "", "", "", "", "", "", "", "", "", "", "", "", "", "", "", "", "", "", "", "", "", "", "", "", "", "", "", "", "", "", "", "", "", "", "", "", "", "","b", "", "", "", "", "", "", "", "", "", "", "", "", "", "", "", "", "", "", "", "", "", "", "", "", "", "", "", "", "", "", "", "", "", "", "", "", "", "", "", "", "", "", "", "", "", "", "", "", "", "", "", "", "", "", "", "", "", "", "", "", "", "","b"],
    ["b", "", "", "", "", "", "", "", "", "", "", "", "", "", "", "", "", "", "", "", "", "", "", "", "", "", "", "", "", "", "", "", "", "", "", "", "", "", "", "", "", "", "", "", "", "", "", "", "", "", "", "", "", "", "", "", "", "", "", "", "", "", "", "", "", "", "", "", "", "", "", "", "", "", "", "", "", "", "", "", "", "", "", "", "", "", "", "", "", "", "", "", "", "", "", "", "", "", "", "", "", "", "", "", "", "", "", "", "", "", "", "", "", "", "", "", "", "", "", "", "", "", "", "", "", "", "", "", "","b"],  
    ["b", "", "", "", "", "", "", "", "", "", "", "", "", "", "", "", "", "", "", "", "", "", "", "", "", "", "", "", "", "", "", "", "", "", "", "", "", "", "", "", "", "", "", "", "", "", "", "", "", "", "", "", "", "", "", "", "", "", "", "", "", "", "", "", "", "", "", "", "", "", "", "", "", "", "", "", "", "", "", "", "", "", "", "", "", "", "", "", "", "", "", "", "", "", "", "", "", "", "", "", "", "", "", "", "", "", "", "", "", "", "", "", "", "", "", "", "", "","b","b","b", "", "", "", "", "", "", "", "","b"], 
    ["b", "", "", "", "", "", "", "", "", "", "", "", "", "", "", "", "", "", "", "", "", "", "", "", "", "", "", "", "", "", "", "", "", "", "", "", "", "", "", "", "", "", "", "", "", "", "", "", "", "", "", "", "", "", "", "", "", "", "", "", "", "", "", "", "", "", "", "", "", "", "", "", "", "", "", "", "", "", "", "", "", "", "", "", "", "", "", "", "", "", "", "", "", "", "", "", "", "", "", "", "", "", "","b","b", "", "", "", "","b","b","b","b", "", "", "", "", "","b","b","b", "", "", "", "", "", "", "", "","b"],   
    ["b", "", "", "", "", "", "", "", "", "", "", "", "", "", "", "", "", "", "", "", "", "", "", "", "", "", "", "", "", "", "", "", "","b","b","b", "", "", "", "", "", "", "", "", "", "", "","b","b","b","b","b", "", "", "", "", "", "", "", "", "", "", "", "", "", "", "", "", "", "", "", "", "", "", "", "", "", "", "", "", "", "", "", "", "", "", "", "", "", "", "", "", "", "", "","b","b","b","b", "", "", "", "","b","b","b", "", "", "", "", "", "", "", "", "", "", "", "","b","b","b", "", "", "", "", "", "", "", "","b"],
    ["b", "", "", "", "", "", "", "", "", "", "", "", "", "", "", "", "", "", "", "", "", "", "","b","b","b", "", "", "", "", "", "", "", "", "", "", "", "", "", "", "", "", "", "","b","b","b","b","b","b","b","b","b","b","b", "", "", "", "", "", "", "", "", "", "", "","b", "", "", "", "", "", "", "", "", "", "", "", "", "", "", "", "", "", "", "", "", "", "", "", "", "", "", "", "", "", "", "", "", "", "", "", "","b","b","b","b", "", "", "", "", "", "", "", "", "", "", "","b","b","b", "", "", "", "", "", "", "", "","b"],
    ["b", "", "", "", "", "", "", "", "", "", "", "", "", "","b","b","b", "", "", "", "", "", "","b","b","b", "", "", "", "", "", "", "", "", "", "", "", "", "","b","b", "", "", "","b","b","b","b","b","b","b","b","b","b","b","b","b","b", "", "", "", "", "", "", "", "","b", "", "", "", "", "", "", "", "", "", "", "", "", "", "", "", "", "","b","b","b","b", "", "", "", "", "", "", "", "", "", "", "", "", "", "", "","b","b","b","b","b", "", "", "", "", "", "", "", "", "", "","b","b","b", "", "", "", "", "", "", "", "","b"],
    ["b", "", "", "", "", "", "", "", "", "", "", "", "", "", "", "", "", "", "", "", "", "", "","b","b","b", "", "","b","b","b", "", "", "", "", "", "", "", "","b","b", "", "", "","b","b","b","b","b","b","b","b","b","b","b","b","b","b","b","b","b", "", "", "", "", "","b", "", "", "", "", "", "", "", "", "", "", "", "", "", "", "", "", "", "", "", "", "", "", "", "", "", "", "", "", "", "", "", "", "", "", "", "","b","b","b","b","b","b", "", "", "", "", "", "", "", "", "","b","b","b", "", "", "", "", "", "", "", "","b"], 
    ["b","p", "", "", "", "","b","b","b", "", "", "", "", "", "", "", "", "", "", "", "", "", "","b","b","b", "", "","b","b","b","b","b","b","b","b","b","b","b","b","b","b","b","b","b","b","b","b","b","b","b","b","b","b","b","b","b","b","b","b","b","b","b","b", "", "","b", "", "", "", "","b","b","b","b","b", "", "", "", "", "", "", "", "", "", "", "", "", "", "", "", "", "", "", "", "", "", "", "", "", "", "", "","b","b","b","b","b","b","b", "", "", "", "", "", "", "", "","b","b","b","e","e","e","e","e","e","e","e","b"],  
    ["b","b","b","b","b","b","b","b","b","b","b","b","b","b","b","b","b","b","b","b","b","b","b","b","b","b","b","b","b","b","b","b","b","b","b","b","b","b","b","b","b","b","b","b","b","b","b","b","b","b","b","b","b","b","b","b","b","b","b","b","b","b","b","b","b","b","b","b","b","b","b","b","b","b","b","b","b","b","b","b","b","b","b","b","b","b","b","b","b","b","b","b","b","b","b","b","b","b","b","b","b","b","b","b","b","b","b","b","b","b","b","b","b","b","b","b","b","b","b","b","b","b","b","b","b","b","b","b","b","b"],
    ["b","b","b","b","b","b","b","b","b","b","b","b","b","b","b","b","b","b","b","b","b","b","b","b","b","b","b","b","b","b","b","b","b","b","b","b","b","b","b","b","b","b","b","b","b","b","b","b","b","b","b","b","b","b","b","b","b","b","b","b","b","b","b","b","b","b","b","b","b","b","b","b","b","b","b","b","b","b","b","b","b","b","b","b","b","b","b","b","b","b","b","b","b","b","b","b","b","b","b","b","b","b","b","b","b","b","b","b","b","b","b","b","b","b","b","b","b","b","b","b","b","b","b","b","b","b","b","b","b","b"],  
    ["b","b","b","b","b","b","b","b","b","b","b","b","b","b","b","b","b","b","b","b","b","b","b","b","b","b","b","b","b","b","b","b","b","b","b","b","b","b","b","b","b","b","b","b","b","b","b","b","b","b","b","b","b","b","b","b","b","b","b","b","b","b","b","b","b","b","b","b","b","b","b","b","b","b","b","b","b","b","b","b","b","b","b","b","b","b","b","b","b","b","b","b","b","b","b","b","b","b","b","b","b","b","b","b","b","b","b","b","b","b","b","b","b","b","b","b","b","b","b","b","b","b","b","b","b","b","b","b","b","b"],
    ["b","b","b","b","b","b","b","b","b","b","b","b","b","b","b","b","b","b","b","b","b","b","b","b","b","b","b","b","b","b","b","b","b","b","b","b","b","b","b","b","b","b","b","b","b","b","b","b","b","b","b","b","b","b","b","b","b","b","b","b","b","b","b","b","b","b","b","b","b","b","b","b","b","b","b","b","b","b","b","b","b","b","b","b","b","b","b","b","b","b","b","b","b","b","b","b","b","b","b","b","b","b","b","b","b","b","b","b","b","b","b","b","b","b","b","b","b","b","b","b","b","b","b","b","b","b","b","b","b","b"],
    ["b","b","b","b","b","b","b","b","b","b","b","b","b","b","b","b","b","b","b","b","b","b","b","b","b","b","b","b","b","b","b","b","b","b","b","b","b","b","b","b","b","b","b","b","b","b","b","b","b","b","b","b","b","b","b","b","b","b","b","b","b","b","b","b","b","b","b","b","b","b","b","b","b","b","b","b","b","b","b","b","b","b","b","b","b","b","b","b","b","b","b","b","b","b","b","b","b","b","b","b","b","b","b","b","b","b","b","b","b","b","b","b","b","b","b","b","b","b","b","b","b","b","b","b","b","b","b","b","b","b"]
  
  ]
}