{
    "settings":"default",
    "maxTime":60,
    "grid": [
    ["b", "", "", "", "", "", "", "", "", "", "", "", "", "", "", "", "", "", "", "", "", "", "", "", "", "", "", "", "", "", "", "", "", "", "", "", "", "", "", "", "", "", "", "", "", "", "", "", "", "", "", "", "", "", "", "", "", "", "", "", "", "", "", "", "", "", "", "", "", "", "", "", "", "", "", "", "", "", "", "", "", "", "", "", "", "", "", "", "", "", "", "", "", "", "", "", "", "", "", "", "", "", "", "", "", "", "", "", "", "", "", "", "", "", "", "", "", "", "", "", "", "", "", "", "", "", "", "", "","b"],
    ["b", "", "", "", "", "", "", "", "", "", "", "","b","b","b", "", "", "", "", "", "", "", "", "", "", "", "", "", "", "", "", "", "", "", "", "", "", "", "", "", "", "", "", "", "", "", "", "", "", "", "", "", "", "", "", "", "", "", "", "", "", "", "", "", "", "", "", "", "", "", "", "", "", "", "", "", "", "", "", "", "", "", "", "", "", "", "", "", "", "", "", "", "", "", "", "", "", "", "", "", "", "", "", "", "", "", "", "", "", "", "", "", "", "", "", "", "", "", "", "", "", "", "", "", "", "", "", "", "","b"],
    ["b", "", "", "", "","p", "", "", "", "", "", "","b","b","b", "", "", "", "", "", "", "", "", "", "", "", "", "", "", "", "", "", "", "", "", "", "", "", "", "", "", "", "", "", "", "", "", "", "", "", "", "", "", "", "", "", "", "", "", "", "", "", "", "", "", "", "", "", "", "", "", "", "", "", "", "", "", "", "", "", "", "", "", "", "", "", "", "", "", "", "", "", "", "", "", "", "", "", "", "", "", "", "", "", "", "", "", "", "", "", "", "", "", "", "", "", "", "", "", "", "", "", "", "", "", "", "", "", "","b"],
    ["b", "", "","b","b","b","b", "", "", "", "", "","b","b","b", "", "", "", "", "", "", "", "", "", "", "","b","b","b", "", "", "", "", "", "", "", "", "", "","b","b","b","b", "", "", "", "", "", "", "", "", "", "", "", "", "", "","b","b","b", "", "", "", "", "", "", "", "", "", "", "", "", "", "","b","b","b", "", "", "", "", "", "", "", "", "", "", "", "", "", "","b","b","b", "", "", "", "", "", "", "", "", "", "", "", "", "", "","b","b","b", "", "", "", "", "", "", "", "", "", "", "", "", "", "", "", "", "", "","b"],
    ["b", "", "","b", "", "", "", "", "", "", "", "", "", "", "", "", "", "", "", "", "", "", "", "", "", "", "", "", "", "", "", "", "", "", "", "", "", "", "", "", "", "","b", "", "", "", "", "", "", "", "", "", "", "", "", "", "", "", "", "", "", "", "", "", "", "", "", "", "", "", "", "", "", "", "", "", "", "", "", "", "", "", "", "", "", "", "", "", "", "", "", "", "", "", "", "", "", "", "", "", "", "", "", "", "", "", "", "", "", "", "", "", "", "", "", "", "", "", "","b","b","b","b", "", "", "", "", "", "","b"],
    ["b", "", "","b", "", "", "", "", "", "", "", "", "", "", "", "", "", "", "", "", "", "", "", "", "", "", "", "", "", "", "", "", "", "", "", "", "", "", "", "", "", "","b", "", "", "", "", "", "", "", "", "", "", "", "", "", "", "", "", "", "", "", "", "", "", "", "", "", "", "", "", "", "", "", "", "", "", "", "", "", "", "", "", "", "", "", "", "", "", "", "", "", "", "", "", "", "", "", "", "", "", "", "", "", "", "", "", "", "", "", "", "", "", "","b","b","b", "", "", "", "", "","b", "", "", "", "", "", "","b"],
    ["b", "", "","b", "", "", "", "", "", "", "", "", "", "", "", "", "", "", "", "", "", "", "", "", "", "", "", "", "", "", "", "", "", "", "", "", "", "", "", "", "", "","b", "", "", "", "", "", "", "", "", "", "", "", "", "", "", "", "", "", "", "", "", "", "", "", "", "", "", "", "", "", "", "", "", "", "", "", "", "", "", "", "", "", "", "", "", "", "", "", "", "", "", "", "", "", "", "", "", "", "", "", "", "", "", "", "", "", "", "", "", "", "", "", "", "", "", "", "", "", "", "","b", "", "", "", "", "", "","b"],
    ["b", "", "","b", "", "", "", "", "", "", "", "", "", "", "", "", "", "", "", "", "", "", "", "", "", "", "", "", "", "", "", "", "", "", "", "", "", "", "", "", "", "","b", "", "", "", "", "", "", "", "", "", "", "", "", "", "", "", "", "", "", "", "", "", "", "", "", "", "", "", "", "", "", "", "", "", "", "", "", "", "", "", "", "", "", "", "", "", "", "", "", "", "", "", "", "", "", "", "", "", "", "", "", "", "", "", "", "","b","b","b", "", "", "", "", "", "", "", "", "", "", "","b", "", "", "", "", "", "","b"],
    ["b", "", "","b", "", "", "", "", "", "", "", "", "", "", "", "", "", "", "", "", "", "", "", "", "", "", "", "", "", "", "", "", "", "", "", "", "", "", "", "", "", "","b", "", "", "", "", "", "", "", "", "", "", "", "", "", "", "", "", "", "", "", "", "", "", "", "", "", "", "", "", "", "", "", "", "", "", "", "", "","b","b","b", "", "", "", "", "", "", "", "", "", "", "","b","b","b", "", "", "", "", "","b","b","b","b", "", "", "", "", "", "", "", "", "", "", "", "", "", "", "", "","b", "", "", "", "", "", "","b"],
    ["b", "", "","b", "", "", "", "", "", "", "", "", "", "", "", "", "", "", "", "", "", "", "", "", "", "", "", "", "", "", "", "", "", "", "", "", "", "", "", "", "", "", "", "", "", "", "", "", "", "", "", "", "", "", "", "", "", "", "", "", "", "", "", "", "", "","b","b","b", "", "", "", "", "", "", "", "", "", "", "", "", "", "", "", "", "", "", "", "", "", "", "", "", "", "", "", "", "", "", "", "", "","b", "", "", "", "", "", "", "", "", "","b","b","b", "", "", "", "", "", "", "","b", "", "", "", "", "", "","b"],
    ["b", "", "","b", "", "", "", "", "", "", "", "", "", "", "", "", "", "", "", "", "", "", "", "", "", "", "", "", "", "", "", "", "", "", "", "", "", "", "", "", "", "", "", "", "", "", "", "", "", "", "", "", "","b","b","b", "", "", "", "", "", "", "", "", "", "", "", "", "", "", "", "", "", "", "", "", "", "", "", "", "", "", "", "", "", "", "", "", "", "", "", "", "", "", "", "", "", "", "", "", "", "","b", "","b","b","b", "", "", "", "", "", "", "", "", "", "", "", "","b","b","b","b", "", "", "", "", "", "","b"],
    ["b", "", "","b", "", "", "", "", "", "", "", "", "", "", "", "", "", "", "", "", "", "", "", "", "", "", "", "", "", "", "", "", "", "", "", "", "", "", "", "", "", "", "", "", "", "", "", "", "", "", "", "", "", "", "", "", "", "", "", "", "", "", "", "", "", "", "", "", "", "", "", "", "", "", "", "", "", "", "", "", "", "", "", "", "", "", "", "", "", "", "", "", "", "", "", "", "", "", "", "", "", "","b", "", "", "", "", "", "", "", "", "", "", "", "", "", "", "", "", "", "", "","b", "", "", "", "", "", "","b"],
    ["b", "", "","b", "", "", "", "", "", "", "", "", "", "", "", "", "", "", "", "", "", "", "", "", "", "", "", "", "", "", "", "", "", "", "", "", "", "", "", "", "", "","b","b","b","b", "", "", "", "", "", "", "", "", "", "", "", "", "", "", "", "", "", "", "", "", "", "", "", "", "", "", "", "", "", "", "", "", "", "", "", "", "", "", "", "", "", "", "", "", "", "", "", "", "", "", "", "", "", "", "", "","b", "",["mb", "1"], "", "", "", "", "", "", "", "", "", "", "", "", "", "", "", "","1","b", "", "", "", "", "", "","b"],
    ["b", "", "","b", "", "", "", "", "", "", "", "", "", "", "", "", "", "", "", "", "", "", "", "", "", "", "", "", "", "", "", "", "", "", "", "", "", "", "", "", "", "","b","b","b","b", "", "", "", "", "", "", "", "", "", "", "", "", "", "", "", "", "", "", "", "", "", "", "", "", "", "", "", "", "", "", "", "", "", "", "", "", "", "", "", "", "", "", "", "", "", "", "", "", "", "", "", "", "", "", "", "","b", "", "", "", "", "", "","b","b","b", "", "", "", "", "", "", "", "", "", "","b", "", "", "", "", "", "","b"],
    ["b", "", "","b", "", "", "", "", "", "","b","b","b", "", "", "", "", "", "", "", "","b","b","b", "", "", "", "", "", "", "", "", "", "", "","b","b","b", "", "", "", "","b","b","b","b","b","b","b","b","b","b","b","b","b","b","b","b","b","b","b","b","b","b","b","b","b","b","b","b","b","b","b","b","b","b","b","b","b","b","b","b","b","b","b","b","b","b","b","b","b","b","b","b","b","b","b","b","b","b","b","b","b", "", "", "", "", "", "", "", "", "", "", "", "", "", "", "", "", "", "", "","b", "", "", "", "", "", "","b"],
    ["b", "", "","b", "", "", "", "", "", "", "", "", "", "", "", "", "", "", "", "", "", "", "", "", "", "", "", "", "", "", "", "", "", "", "", "", "", "", "", "", "", "", "", "", "", "", "", "", "", "", "", "", "", "", "", "", "", "", "", "", "", "", "", "", "", "", "", "", "", "", "", "", "", "", "", "", "", "", "", "", "", "", "", "", "", "", "", "", "", "", "", "", "", "", "", "", "", "", "", "", "", "", "", "", "", "", "", "", "", "", "", "", "", "", "", "","b","b","b", "", "", "","b", "", "", "", "", "", "","b"],
    ["b", "", "","b", "", "", "", "", "", "", "", "", "", "", "", "", "", "", "", "", "", "", "", "", "", "", "", "", "", "", "", "", "", "", "", "", "", "", "", "", "", "", "", "", "", "", "", "", "", "", "", "", "", "", "", "", "", "", "", "", "", "", "", "", "", "", "", "", "", "", "", "", "", "", "", "", "", "", "", "", "", "", "", "", "", "", "", "", "", "", "", "", "", "", "", "", "", "", "", "", "", "", "","b","b","b", "", "","b","b","b", "", "", "", "", "", "", "", "", "", "", "","b", "", "", "", "", "", "","b"],
    ["b", "", "","b", "", "", "", "", "", "", "", "", "", "", "", "", "", "", "", "", "", "", "", "", "", "", "", "", "", "", "", "", "", "", "", "", "", "", "", "", "", "", "", "", "", "", "", "", "", "", "", "", "", "", "", "", "", "", "", "", "", "", "", "", "", "", "", "", "", "", "", "", "", "", "", "", "", "", "", "", "", "", "", "", "", "", "", "", "", "", "", "", "", "", "", "", "", "", "", "", "", "", "", "", "", "", "", "", "", "", "", "", "", "", "", "", "", "", "", "", "","b","b", "", "", "", "", "", "","b"],
    ["b", "", "","b", "", "", "", "", "", "", "", "", "", "", "", "", "", "", "", "", "", "", "", "", "", "", "", "", "", "", "", "", "", "", "", "", "", "", "", "", "", "", "", "", "", "", "", "", "", "", "", "", "", "", "", "", "", "", "", "", "", "", "", "", "", "", "", "", "", "", "", "", "", "", "", "", "", "", "", "", "", "", "", "", "", "", "", "", "", "", "", "", "", "", "", "", "", "", "", "", "", "", "", "", "", "", "", "", "", "", "", "", "","b","b","b", "", "", "","b","b","b","b", "", "", "", "", "", "","b"],  
    ["b", "", "","b", "", "", "", "", "", "", "", "", "", "", "", "", "", "", "", "", "", "", "", "", "", "", "", "", "", "", "", "", "", "", "", "", "", "", "", "", "", "", "", "", "", "", "", "", "", "", "", "", "", "", "", "", "", "", "", "", "", "", "", "", "", "", "", "", "", "", "", "", "", "", "", "", "", "", "", "", "", "", "", "", "", "", "", "", "", "", "", "", "", "", "", "", "", "", "", "", "", "", "", "", "", "", "", "", "", "", "", "", "", "", "", "", "", "", "", "", "", "","b", "", "", "", "", "", "","b"], 
    ["b", "", "","b", "", "", "", "", "", "", "", "", "", "", "", "", "", "", "", "", "", "", "", "", "", "", "", "", "", "", "", "", "", "", "", "", "", "", "", "", "", "", "", "", "", "", "", "", "", "", "", "", "","b","b","b","b", "", "", "", "", "", "", "", "", "","b","b","b", "", "", "", "", "", "", "", "", "", "", "","b","b","b", "", "", "", "", "", "", "", "", "", "", "", "", "", "", "", "", "", "", "", "", "", "", "", "","b","b","b", "", "", "", "", "", "", "", "", "", "", "", "","b", "", "", "", "", "", "","b"],   
    ["b", "", "","b", "", "", "", "", "", "", "", "", "", "", "", "", "", "", "", "", "", "", "", "", "", "", "", "", "", "", "", "", "", "", "", "", "", "", "", "","b","b","b", "", "", "", "", "", "", "", "", "", "", "", "", "", "", "", "", "", "", "", "", "", "", "", "", "", "", "", "", "", "", "", "", "", "", "", "", "", "", "", "", "", "", "", "", "", "", "", "", "", "", "", "", "", "", "", "", "", "", "", "", "", "", "", "", "", "", "", "", "", "", "", "", "", "", "", "", "", "", "","b", "", "", "", "", "", "","b"],
    ["b", "", "","b", "", "", "", "", "", "", "", "", "", "", "", "", "", "", "", "", "", "", "", "", "", "", "", "", "", "", "", "", "", "", "", "", "", "", "", "","b","b","b", "", "", "", "", "", "", "", "", "", "", "", "", "", "", "", "", "", "", "", "", "", "", "", "", "", "", "", "", "", "", "", "", "", "", "", "", "", "", "", "", "", "", "", "", "", "", "", "", "", "", "", "", "", "","b","b","b","b","b","b", "", "", "", "", "", "", "", "", "", "","b","b","b", "", "", "", "", "", "","b", "", "", "", "", "", "","b"],
    ["b", "", "","b", "", "", "", "", "", "", "", "", "", "", "", "", "", "", "", "", "", "", "", "", "", "", "", "", "", "","b","b","b", "", "", "", "", "", "", "","b","b","b", "", "", "", "", "", "", "", "", "", "", "", "", "", "", "", "", "", "", "", "", "", "", "", "", "", "", "", "", "", "", "", "", "", "", "", "", "", "", "", "", "", "", "", "", "", "", "", "", "", "", "","b","b","b","b","b","b","b","b","b", "", "", "", "", "", "", "", "", "", "", "", "", "", "", "", "", "", "", "","b", "", "", "", "", "", "","b"],
    ["b", "", "", "", "", "", "", "", "", "", "", "", "", "", "", "", "","b","b","b","b", "", "", "", "", "", "", "", "", "", "", "", "", "", "", "", "", "", "", "","b","b","b", "", "", "", "", "", "", "", "", "", "", "", "", "", "", "", "", "", "", "", "", "", "", "", "", "", "", "", "", "", "", "", "", "", "", "", "", "", "", "", "", "", "", "", "", "", "", "", "","b","b","b","b","b","b","b","b","b","b","b","b", "", "", "", "", "", "", "", "", "", "", "", "", "", "", "", "","b","b","b","b", "", "", "", "", "", "","b"], 
    ["b", "", "", "", "", "", "","b","b","b", "", "", "", "", "", "", "","b","b","b","b", "", "", "", "", "", "", "", "", "", "", "", "", "", "", "", "", "", "", "","b","b","b", "", "", "", "", "", "", "", "", "", "", "", "", "", "", "", "", "", "", "", "", "", "", "", "", "", "", "", "", "", "", "", "", "", "", "", "", "", "", "", "", "", "", "", "", "","b","b","b","b","b","b","b","b","b","b","b","b","b","b","b", "", "", "", "", "", "", "", "", "", "", "", "", "", "", "", "","b","b","b","b","e","e","e","e","e","e","b"],  
    ["b","b","b","b","b","b","b","b","b","b","b","b","b","b","b","b","b","b","b","b","b","b","b","b","b","b","b","b","b","b","b","b","b","b","b","b","b","b","b","b","b","b","b","b","b","b","b","b","b","b","b","b","b","b","b","b","b","b","b","b","b","b","b","b","b","b","b","b","b","b","b","b","b","b","b","b","b","b","b","b","b","b","b","b","b","b","b","b","b","b","b","b","b","b","b","b","b","b","b","b","b","b","b","b","b","b","b","b","b","b","b","b","b","b","b","b","b","b","b","b","b","b","b","b","b","b","b","b","b","b"],
    ["b","b","b","b","b","b","b","b","b","b","b","b","b","b","b","b","b","b","b","b","b","b","b","b","b","b","b","b","b","b","b","b","b","b","b","b","b","b","b","b","b","b","b","b","b","b","b","b","b","b","b","b","b","b","b","b","b","b","b","b","b","b","b","b","b","b","b","b","b","b","b","b","b","b","b","b","b","b","b","b","b","b","b","b","b","b","b","b","b","b","b","b","b","b","b","b","b","b","b","b","b","b","b","b","b","b","b","b","b","b","b","b","b","b","b","b","b","b","b","b","b","b","b","b","b","b","b","b","b","b"],  
    ["b","b","b","b","b","b","b","b","b","b","b","b","b","b","b","b","b","b","b","b","b","b","b","b","b","b","b","b","b","b","b","b","b","b","b","b","b","b","b","b","b","b","b","b","b","b","b","b","b","b","b","b","b","b","b","b","b","b","b","b","b","b","b","b","b","b","b","b","b","b","b","b","b","b","b","b","b","b","b","b","b","b","b","b","b","b","b","b","b","b","b","b","b","b","b","b","b","b","b","b","b","b","b","b","b","b","b","b","b","b","b","b","b","b","b","b","b","b","b","b","b","b","b","b","b","b","b","b","b","b"],
    ["b","b","b","b","b","b","b","b","b","b","b","b","b","b","b","b","b","b","b","b","b","b","b","b","b","b","b","b","b","b","b","b","b","b","b","b","b","b","b","b","b","b","b","b","b","b","b","b","b","b","b","b","b","b","b","b","b","b","b","b","b","b","b","b","b","b","b","b","b","b","b","b","b","b","b","b","b","b","b","b","b","b","b","b","b","b","b","b","b","b","b","b","b","b","b","b","b","b","b","b","b","b","b","b","b","b","b","b","b","b","b","b","b","b","b","b","b","b","b","b","b","b","b","b","b","b","b","b","b","b"],
    ["b","b","b","b","b","b","b","b","b","b","b","b","b","b","b","b","b","b","b","b","b","b","b","b","b","b","b","b","b","b","b","b","b","b","b","b","b","b","b","b","b","b","b","b","b","b","b","b","b","b","b","b","b","b","b","b","b","b","b","b","b","b","b","b","b","b","b","b","b","b","b","b","b","b","b","b","b","b","b","b","b","b","b","b","b","b","b","b","b","b","b","b","b","b","b","b","b","b","b","b","b","b","b","b","b","b","b","b","b","b","b","b","b","b","b","b","b","b","b","b","b","b","b","b","b","b","b","b","b","b"]
  
  ]
}