{
    "settings":"default",
    "maxTime":50,
    "grid": [
    ["d", "", "", "", "", "", "", "", "", "", "", "", "", "", "", "", "", "", "", "", "", "", "", "", "", "", "", "", "", "", "", "", "", "", "", "", "", "", "", "", "", "", "", "", "", "", "", "", "", "", "", "", "", "", "", "", "", "", "", "", "", "", "", "", "", "", "", "", "", "", "", "", "", "", "", "", "", "", "", "", "", "", "", "", "", "", "", "", "", "", "", "", "", "", "", "", "", "", "", "", "", "", "", "", "", "", "", "", "", "", "", "", "", "", "", "", "", "", "", "", "", "", "", "", "", "", "", "", "","d"],
    ["d", "", "", "", "", "", "", "", "", "", "", "", "", "", "", "", "", "", "", "", "", "", "", "", "", "", "", "", "", "", "", "", "", "", "", "", "", "", "", "", "", "", "", "", "", "", "", "", "", "", "", "", "", "", "", "", "", "", "", "", "", "", "", "", "", "", "", "", "", "", "", "", "", "", "", "", "", "", "", "", "", "", "", "", "", "", "", "", "", "", "", "", "", "", "", "", "", "", "", "", "", "", "", "", "", "", "", "", "", "", "", "", "", "", "", "", "", "", "", "", "", "", "", "", "", "", "", "", "","d"],
    ["d", "", "", "", "", "", "", "", "", "", "", "", "", "", "", "", "", "", "", "", "", "", "", "", "", "", "", "", "", "", "", "", "", "", "", "", "", "", "", "", "", "", "", "", "", "", "", "", "", "", "", "", "", "", "", "", "", "", "", "", "", "", "", "", "", "", "", "", "", "", "", "", "", "", "", "", "", "", "", "", "", "", "", "", "", "", "", "", "", "", "", "", "", "", "", "", "", "", "", "", "", "", "", "", "", "", "", "", "", "", "", "", "", "", "", "", "", "", "", "", "", "", "", "", "", "", "", "", "","d"],
    ["d", "", "", "", "", "", "", "", "", "", "", "", "", "", "", "", "", "", "", "", "", "", "", "", "", "", "", "", "", "", "", "", "", "", "", "", "", "", "", "", "", "", "", "", "", "", "", "", "", "", "", "", "", "", "", "", "", "", "", "", "", "", "", "", "", "", "", "", "", "", "", "", "", "", "", "", "", "", "", "", "", "", "", "", "", "", "", "", "", "", "", "", "", "", "", "", "", "", "", "", "", "", "", "", "", "", "", "", "", "", "", "", "", "", "", "", "", "", "","g","g","g", "", "", "", "", "", "", "","d"],
    ["d", "", "", "", "", "", "", "", "", "", "", "", "", "", "", "", "", "", "", "", "", "", "", "", "", "", "", "", "", "", "", "", "", "", "", "", "", "", "", "", "", "", "", "", "", "", "", "", "", "", "", "", "", "", "", "", "", "", "", "", "", "", "", "", "", "", "", "", "", "", "", "", "", "", "", "", "", "", "", "", "", "", "", "", "", "", "", "", "", "", "", "", "", "", "", "", "", "", "", "", "", "", "", "", "", "", "", "", "", "","s","s","s", "", "", "", "", "", "","d","d","d","g", "", "", "", "", "", "","d"],
    ["d", "", "", "", "", "", "", "", "", "", "", "", "", "", "", "", "", "", "", "", "", "", "", "", "", "", "", "", "", "", "", "", "", "", "", "", "", "", "", "", "", "", "", "", "", "", "", "", "", "", "", "", "", "", "", "", "", "", "", "", "", "", "", "", "", "", "", "", "", "", "", "", "", "", "", "", "", "", "", "", "", "", "", "", "", "", "", "", "", "", "", "", "", "", "", "", "", "", "", "", "", "", "", "", "", "", "", "", "", "", "", "", "", "", "", "", "", "","g","d","d","d","d", "", "", "", "", "", "","d"],
    ["d", "", "", "", "", "", "", "", "", "", "", "", "", "", "", "", "", "", "", "", "", "", "", "", "", "", "", "", "", "", "", "", "", "", "", "", "", "", "", "", "", "", "", "", "", "", "", "", "", "", "", "", "", "", "", "", "", "", "", "", "", "", "", "", "", "", "", "", "", "", "", "", "", "", "", "", "", "", "", "", "", "", "", "", "", "", "", "", "", "", "", "", "", "", "", "", "", "", "", "", "","g","g","g", "", "", "", "", "", "", "", "", "", "", "", "", "", "","d","d","d","d","d", "", "", "", "", "", "","d"],
    ["d", "", "", "", "", "", "", "", "", "", "", "", "", "", "", "", "", "", "", "", "", "", "", "", "", "", "", "", "", "", "", "", "", "", "", "", "", "", "", "", "", "", "", "", "", "", "", "", "", "", "", "", "", "", "", "", "", "", "", "", "", "", "", "", "", "", "", "", "", "", "", "", "", "", "", "", "", "", "", "", "", "", "", "", "", "", "", "", "", "", "", "", "", "", "", "", "", "", "", "", "","d","d","d", "", "", "", "", "", "", "", "", "", "", "", "", "", "","d","d","d","d","d","g", "", "", "", "", "","d"],
    ["d", "", "", "", "", "", "", "", "", "", "", "", "", "", "", "", "", "", "", "", "", "", "", "", "", "", "", "", "", "", "", "", "", "", "", "", "", "", "", "", "", "", "","g","g","g", "", "", "", "", "", "", "", "", "", "", "", "", "", "", "", "", "", "", "", "", "", "", "", "", "", "", "", "", "", "", "", "", "", "", "", "", "", "", "", "", "", "", "", "", "", "", "", "", "", "", "", "", "", "", "", "", "", "", "", "", "", "", "","s","s","s", "", "", "", "", "", "","d","d","d","d","d","d", "", "", "", "", "","d"],
    ["d", "", "", "", "", "", "", "", "", "", "", "", "", "", "", "", "", "", "", "", "", "", "", "", "", "", "", "", "", "", "","g","g","g", "", "", "", "", "", "", "", "", "","d","d","d", "", "", "", "", "", "", "", "", "", "", "", "", "", "","g","g","g", "", "", "", "", "", "", "", "", "", "", "", "", "", "", "", "", "", "", "", "", "", "", "", "", "", "", "", "", "", "", "", "", "", "", "", "", "", "", "", "", "", "", "", "", "", "", "", "", "", "", "", "", "", "", "","d","d","d","d","d","d", "", "", "", "", "","d"],
    ["d", "", "", "", "", "", "", "", "", "", "", "", "", "", "", "", "", "","g","g","g","g","g", "", "", "", "", "", "", "", "","d","d","d", "", "", "", "", "", "", "", "", "", "", "", "", "", "", "", "", "", "", "", "", "", "", "", "", "", "","d","d","d", "", "", "", "", "", "", "", "", "", "", "", "", "", "", "", "", "", "", "", "", "", "", "", "", "", "", "", "", "", "", "", "", "", "", "", "", "", "", "", "", "", "", "", "", "", "", "", "", "", "", "", "", "","g","g","d","d","d","d","d","d", "", "", "", "", "","d"],
    ["d", "", "", "", "", "", "", "", "", "", "", "", "", "", "", "", "","g","d","d","d","d","d", "", "", "", "", "", "", "", "", "", "", "", "", "", "", "", "", "", "", "", "", "", "", "", "", "", "", "", "", "", "", "", "", "", "", "", "", "", "", "", "", "", "", "", "", "", "", "", "", "", "", "", "", "", "", "", "", "", "", "", "", "", "", "", "", "", "", "", "", "", "", "", "", "", "", "", "", "", "", "", "", "", "", "", "", "", "", "", "", "", "", "", "", "","d","d","d","d","d","d","d","d", "", "", "", "", "","d"],
    ["d", "", "", "", "", "", "", "", "", "", "", "","g","g","g","g","g","d","d","d","d","d", "", "", "", "", "", "", "", "", "", "", "", "", "", "", "", "", "", "", "", "", "", "", "", "", "", "", "", "", "", "", "", "", "", "", "", "", "", "", "", "", "", "", "", "", "", "", "", "", "", "", "", "", "", "", "", "", "", "", "", "", "", "", "", "", "", "", "", "", "", "", "", "", "", "", "", "", "", "", "", "", "", "", "", "", "", "", "","g","g","g", "", "", "", "","d","d","d","d","d","d","d","d","g", "", "", "", "","d"],
    ["d", "", "", "", "", "", "", "", "", "", "", "","d","d","d","d","d","d","d","d","d", "", "", "", "", "", "", "", "", "", "", "", "", "", "", "", "", "", "", "", "", "", "", "", "", "", "", "", "", "", "", "", "", "", "", "", "", "", "", "", "", "", "", "", "", "", "", "", "", "", "", "", "", "", "", "", "", "", "", "", "", "", "", "", "", "", "", "", "", "", "", "", "", "","g","g","g", "", "", "", "", "", "", "", "", "", "", "", "","d","d","d", "", "", "","g","d","d","d","d","d","d","d","d","d", "", "", "", "","d"],
    ["d", "", "", "", "","s","s","s", "", "", "", "", "","d","d","d","d","d","d","d","d", "", "", "", "", "", "", "", "", "", "", "", "", "", "", "", "", "", "", "", "", "", "", "", "", "", "", "", "", "", "", "", "", "", "", "", "", "", "", "", "", "", "", "", "", "", "", "", "", "", "", "", "", "", "", "", "", "","g","g","g","g","g","g","g", "", "", "", "", "", "", "", "", "","d","d","d", "", "", "", "", "", "", "", "", "", "", "", "", "", "", "", "", "", "","d","d","d","d","d","d","d","d","d","d", "", "", "", "","d"],
    ["d", "", "", "", "", "", "", "", "", "", "", "", "", "","d","d","d","d","d","d","d", "", "", "", "", "", "", "", "", "", "", "", "", "", "", "", "", "", "", "", "", "", "", "", "", "", "", "", "", "", "", "", "", "", "", "", "", "", "", "", "", "", "", "", "", "", "", "", "", "", "", "", "", "", "", "", "", "","d","d","d","d","d","d","d", "", "", "", "", "", "", "", "", "", "", "", "", "", "", "", "", "", "", "", "", "", "", "", "", "", "", "", "", "", "","d","d","d","d","d","d","d","d","d","d", "", "", "", "","d"],
    ["d","g","g", "", "", "", "", "", "", "", "", "", "", "","d","d","d","d","d","d","d", "", "", "", "", "", "", "", "", "", "", "", "", "", "", "", "", "", "", "", "", "", "", "", "", "", "", "", "", "", "", "", "", "", "", "", "", "", "", "", "", "", "", "", "", "","g","g","g", "", "", "", "", "", "", "", "", "", "","d","d","d","d","d","d","g","g", "", "", "", "", "", "", "", "", "", "", "", "", "", "", "", "", "", "", "", "", "", "", "", "", "", "", "", "","d","d","d","d","d","d","d","d","d","d", "", "", "", "","d"],
    ["d","d","d", "", "", "", "", "", "", "", "", "", "", "","d","d","d","d","d","d", "", "", "", "", "", "", "", "", "", "", "", "", "", "", "", "", "", "", "", "", "", "", "", "", "", "", "", "", "", "", "", "", "", "","g","g","g", "", "", "", "", "", "", "", "", "","d","d","d", "", "", "", "", "", "", "", "", "", "","d","d","d","d","d","d","d","d", "", "", "", "", "", "", "", "", "", "", "", "", "", "", "", "", "", "", "", "", "", "", "", "", "", "", "","g","d","d","d","d","d","d","d","d","d","d", "", "", "", "","d"],
    ["d","d","d", "", "", "","s","s","s", "", "", "", "", "","d","d","d","d","d","d", "", "", "", "", "", "", "", "","b","b","b","b","b", "", "", "", "", "", "", "", "", "","g","g","g","g", "", "", "", "", "", "", "", "","d","d","d", "", "", "", "", "", "", "", "", "", "", "", "", "", "", "", "", "", "", "", "", "", "","d","d","d","d","d","d","d","d","g", "", "", "", "", "", "", "", "", "", "", "", "", "", "", "", "", "", "", "", "", "", "", "", "", "", "","d","d","d","d","d","d","d","d","d","d","d","g", "", "", "","d"],  
    ["d","d", "", "", "", "", "", "", "", "", "", "", "", "","d","d","d","d","d","d", "", "", "", "", "", "", "", "", "", "", "", "", "", "", "", "", "", "", "", "", "", "","d","d","d","d","g", "", "", "", "", "", "", "", "", "", "", "", "", "", "", "", "", "", "", "", "", "", "", "", "", "", "", "", "", "", "", "","g","d","d","d","d","d","d","d","d","d", "", "", "", "", "", "", "", "", "", "", "", "", "", "", "", "", "", "", "", "", "", "", "", "", "", "","d","d","d","d","d","d","d","d","d","d","d","d", "", "", "","d"], 
    ["d","d", "", "", "", "", "", "", "", "", "", "", "","g","d","d","d","d","d","d", "", "", "", "", "", "", "", "", "", "", "", "", "", "", "", "", "", "", "", "","g","g","d","d","d","d","d", "", "", "", "", "", "", "", "", "", "", "", "", "", "", "", "", "", "", "", "", "", "", "", "", "", "", "", "", "", "", "","d","d","d","d","d","d","d","d","d","d","g", "","b","b","b", "", "", "", "", "", "", "", "", "", "", "", "", "", "", "", "", "", "", "","g","g","d","d","d","d","d","d","d","d","d","d","d","d", "", "", "","d"],   
    ["d", "", "", "", "", "", "", "", "", "", "", "", "","d","d","d","d","d","d","d", "", "", "", "", "", "", "", "", "", "", "", "", "", "", "", "", "", "", "", "","d","d","d","d","d","d","d","g", "", "", "", "", "", "", "", "", "", "", "", "", "", "", "", "", "", "", "", "", "", "", "", "", "", "", "", "", "", "","d","d","d","d","d","d","d","d","d","d","d", "", "", "", "", "", "", "", "", "", "", "", "", "", "", "", "", "", "", "", "", "", "", "","d","d","d","d","d","d","d","d","d","d","d","d","d","d", "", "","g","d"],
    ["d", "", "", "", "", "","s","s","s", "", "", "", "","d","d","d","d","d","d","d","g", "", "", "", "", "", "", "", "", "", "", "", "", "", "", "", "", "", "","g","d","d","d","d","d","d","d","d", "", "", "", "", "", "", "", "", "", "", "", "", "", "", "", "", "", "", "", "", "", "", "", "", "", "", "", "", "", "","d","d","d","d","d","d","d","d","d","d","d","g","g", "", "", "","b","b","b","b", "", "", "", "", "", "", "", "", "", "", "", "", "", "","d","d","d","d","d","d","d","d","d","d","d","d","d","d", "", "","d","d"],
    ["d", "", "", "", "", "", "", "", "", "", "", "", "","d","d","d","d","d","d","d","d", "", "", "", "", "", "", "", "", "", "", "", "", "","b","b","b", "", "","d","d","d","d","d","d","d","d","d","g","g","g", "", "", "", "", "", "", "", "", "", "", "", "", "", "", "", "", "", "", "", "", "", "", "", "", "", "","g","d","d","d","d","d","d","d","d","d","d","d","d","d", "", "", "", "", "", "", "", "", "", "", "", "", "", "", "", "", "", "", "", "","g","d","d","d","d","d","d","d","d","d","d","d","d","d","d", "", "","d","d"],
    ["d", "", "", "", "", "", "", "", "", "", "", "","g","d","d","d","d","d","d","d","d", "", "", "", "", "", "", "", "", "", "", "", "","b","b","b","b","g","g","d","d","d","d","d","d","d","d","d","d","d","d", "", "", "", "", "", "", "", "", "", "", "", "", "", "", "", "", "", "", "", "", "", "", "", "", "", "","d","d","d","d","d","d","d","d","d","d","d","d","d","d","g", "", "", "", "", "", "", "", "","b","b","b", "", "", "", "", "", "", "", "","d","d","d","d","d","d","d","d","d","d","d","d","d","d","d", "", "","d","d"], 
    ["d","p", "", "", "", "", "", "", "", "", "","g","d","d","d","d","d","d","d","d","d","g", "", "", "", "", "", "", "","b","b","b","b","b","b","b","b","d","d","d","d","d","d","d","d","d","d","d","d","d","d","g","g","g","g","g", "", "", "", "", "", "", "", "", "", "", "", "", "", "", "", "", "", "", "", "", "","d","d","d","d","d","d","d","d","d","d","d","d","d","d","d", "", "", "", "", "", "", "", "", "", "", "", "", "", "", "", "", "", "", "","d","d","d","d","d","d","d","d","d","d","d","d","d","d","d", "", "","d","d"],  
    ["d","g","g","g","g","g","g","g","g","g","g","d","d","d","d","d","d","d","d","d","d","d","g","g","g","g","g","g","g","g","g","g","g","g","g","g","g","d","d","d","d","d","d","d","d","d","d","d","d","d","d","d","d","d","d","d","g","g","g","g","g","g","g","g","g","g","g","g","g","g","g","g","g","g","g","g","g","d","d","d","d","d","d","d","d","d","d","d","d","d","d","d","g","g","g","g","g","g","g","g","g","g","g","g","g","g","g","g","g","g","g","d","d","d","d","d","d","d","d","d","d","d","d","d","d","d","e","e","d","d"],
    ["d","d","d","d","d","d","d","d","d","d","d","d","d","d","d","d","d","d","d","d","d","d","d","d","d","d","d","d","d","d","d","d","d","d","d","d","d","d","d","d","d","d","d","d","d","d","d","d","d","d","d","d","d","d","d","d","d","d","d","d","d","d","d","d","d","d","d","d","d","d","d","d","d","d","d","d","d","d","d","d","d","d","d","d","d","d","d","d","d","d","d","d","d","d","d","d","d","d","d","d","d","d","d","d","d","d","d","d","d","d","d","d","d","d","d","d","d","d","d","d","d","d","d","d","d","d","d","d","d","d"],  
    ["d","d","d","d","d","d","d","d","d","d","d","d","d","d","d","d","d","d","d","d","d","d","d","d","d","d","d","d","d","d","d","d","d","d","d","d","d","d","d","d","d","d","d","d","d","d","d","d","d","d","d","d","d","d","d","d","d","d","d","d","d","d","d","d","d","d","d","d","d","d","d","d","d","d","d","d","d","d","d","d","d","d","d","d","d","d","d","d","d","d","d","d","d","d","d","d","d","d","d","d","d","d","d","d","d","d","d","d","d","d","d","d","d","d","d","d","d","d","d","d","d","d","d","d","d","d","d","d","d","d"],
    ["d","d","d","d","d","d","d","d","d","d","d","d","d","d","d","d","d","d","d","d","d","d","d","d","d","d","d","d","d","d","d","d","d","d","d","d","d","d","d","d","d","d","d","d","d","d","d","d","d","d","d","d","d","d","d","d","d","d","d","d","d","d","d","d","d","d","d","d","d","d","d","d","d","d","d","d","d","d","d","d","d","d","d","d","d","d","d","d","d","d","d","d","d","d","d","d","d","d","d","d","d","d","d","d","d","d","d","d","d","d","d","d","d","d","d","d","d","d","d","d","d","d","d","d","d","d","d","d","d","d"],
    ["d","d","d","d","d","d","d","d","d","d","d","d","d","d","d","d","d","d","d","d","d","d","d","d","d","d","d","d","d","d","d","d","d","d","d","d","d","d","d","d","d","d","d","d","d","d","d","d","d","d","d","d","d","d","d","d","d","d","d","d","d","d","d","d","d","d","d","d","d","d","d","d","d","d","d","d","d","d","d","d","d","d","d","d","d","d","d","d","d","d","d","d","d","d","d","d","d","d","d","d","d","d","d","d","d","d","d","d","d","d","d","d","d","d","d","d","d","d","d","d","d","d","d","d","d","d","d","d","d","d"]
  
  ]
}